10 20
......x...
.x....x...
x....x....
.x........
.x........
x..x.x.x..
..x...x..x
x.x.x.x.x.
..........
x.x.x.x.x.
..x.x..x.x
x.x..x..x.
xxx.x..x..
