20 20
...............x....
.....x........x.x...
..............x.....
..........x....x.x.x
.....x.x...........x
......x..xxx........
x....x....x.........
x..x.x...........x..
....................
....................
......x.............
.x............x..x..
x.......x....x......
.x............xx....
.........x..........
..x............x....
.x...............x..
..xx.......x........
.xx.................
..........x......x..
